# #####  B
# ##### ##
     ## ##
# ## ## ##
# #   #  #
# ##### ##
#       ##
#### #####
#### #####
A    #####